1 15 25
2 2 2 2 2 2 2 2 2 2 2 2 2 2 2 2 2 2 2 2 2 2 2 2 2
2 ! 0 3 0 0 0 3 0 0 B 0 0 0 3 0 0 0 3 0 0 0 0 0 2
2 0 2 3 2 3 2 0 2 3 2 3 2 0 2 0 2 3 2 0 2 3 2 3 2
2 0 3 0 0 0 0 0 0 0 1 0 3 0 3 0 0 3 3 0 0 0 0 0 2
2 0 2 0 2 3 2 0 2 0 2 0 2 0 2 3 2 0 2 0 2 0 2 0 2
2 0 5 0 0 0 0 0 3 0 0 0 3 0 3 0 0 B 0 0 3 0 0 0 2
2 0 2 0 2 3 2 0 2 0 2 3 2 0 2 0 2 0 2 0 2 0 2 0 2
2 0 0 3 0 0 0 0 3 O 0 0 0 0 3 0 3 0 3 0 0 4 0 0 2
2 0 2 0 2 3 2 0 2 0 2 0 2 0 2 0 2 0 2 0 2 3 2 3 2
2 0 0 0 0 0 3 0 0 0 0 0 3 0 0 0 3 0 0 5 3 0 3 0 2
2 3 2 0 2 0 2 0 2 0 2 0 2 0 2 0 2 3 2 0 2 0 2 0 2
2 6 0 3 0 0 0 0 0 0 0 0 0 0 3 0 0 0 3 0 3 0 0 0 2
2 0 2 3 2 3 2 0 2 3 2 3 2 0 2 0 2 0 2 0 2 3 2 3 2
2 0 0 0 3 0 B 0 0 0 3 0 0 0 3 0 0 0 3 0 O 0 4 0 2
2 2 2 2 2 2 2 2 2 2 2 2 2 2 2 2 2 2 2 2 2 2 2 2 2