3 15 25
2 2 2 2 2 2 2 2 2 2 2 2 2 2 2 2 2 2 2 2 2 2 2 2 2
2 0 0 K 0 0 0 3 8 0 0 0 ! 0 0 0 3 3 0 0 0 K 0 0 2
2 0 0 0 0 0 0 3 3 0 0 0 0 0 0 0 3 3 0 0 0 0 0 0 2
2 3 3 3 3 5 3 3 3 3 3 3 3 3 6 3 3 3 3 3 3 3 3 3 2
2 0 2 0 0 0 0 3 0 2 0 0 0 0 0 2 0 3 2 2 2 2 2 0 2
2 0 2 0 0 0 0 3 0 2 0 0 0 0 0 2 0 1 0 0 0 0 2 0 2
2 0 2 0 0 0 0 4 0 2 0 0 0 0 0 2 0 3 0 0 O 0 2 0 2
2 0 2 O 0 0 0 3 0 2 0 0 0 0 0 2 0 3 2 2 2 2 2 0 2
2 0 2 0 0 0 0 3 0 0 2 0 D 0 2 0 0 3 0 0 0 0 2 0 2
2 0 2 0 0 0 0 3 0 0 0 2 0 2 0 0 0 4 0 0 0 0 2 0 2
2 0 2 2 2 2 2 3 0 0 0 0 2 0 0 0 0 3 2 2 2 2 2 0 2
2 3 5 3 3 3 3 3 3 3 6 3 3 3 3 3 5 3 3 3 3 3 3 3 2
2 0 0 B 0 0 0 3 0 0 0 0 0 0 0 0 0 3 0 0 0 B 0 0 2
2 0 0 0 0 0 0 3 0 0 0 0 D 0 0 0 0 3 0 0 0 0 0 0 2
2 2 2 2 2 2 2 2 2 2 2 2 2 2 2 2 2 2 2 2 2 2 2 2 2