4 15 25
2 2 2 2 2 2 2 2 2 2 2 2 2 2 2 2 2 2 2 2 2 2 2 2 2
2 ! 0 0 0 0 0 0 0 2 0 0 0 0 0 0 3 0 0 0 0 0 0 0 2
2 2 2 2 3 2 2 2 3 5 2 2 2 7 2 2 2 2 2 2 2 2 2 0 2
2 0 0 0 0 0 0 0 3 0 0 0 2 K 2 0 0 0 0 0 0 0 2 0 2
2 0 2 2 2 2 2 2 2 3 2 2 2 3 2 2 2 2 2 2 2 0 2 3 2
2 0 8 0 3 0 2 0 0 0 0 3 0 0 0 0 0 0 0 2 3 0 2 0 2
2 0 2 0 2 3 2 2 2 2 2 3 2 2 2 2 2 2 0 0 3 0 3 0 2
2 2 4 2 2 0 0 2 1 0 2 3 0 0 0 0 4 2 2 0 2 0 3 D 2
2 0 3 3 3 0 2 2 3 2 2 2 2 2 3 2 2 2 0 2 2 0 2 0 2
2 K 2 K 2 0 2 0 0 0 0 0 0 2 0 0 0 0 0 0 2 0 3 0 2
2 0 2 0 2 2 2 2 2 2 3 2 2 2 2 2 2 3 2 2 2 0 2 0 2
2 0 3 0 0 2 0 0 0 0 0 0 0 0 2 0 0 0 0 0 0 0 2 0 2
2 0 2 2 2 2 2 2 3 2 2 2 2 2 2 2 2 2 2 3 2 2 2 0 2
2 0 0 0 0 3 0 3 0 0 0 0 2 0 0 0 0 0 0 0 2 6 0 0 2
2 2 2 2 2 2 2 2 2 2 2 2 2 2 2 2 2 2 2 2 2 2 2 2 2