2 15 25
2 2 2 2 2 2 2 2 2 2 2 2 2 2 2 2 2 2 2 2 2 2 2 2 2
2 ! 0 3 0 0 0 3 0 0 0 0 3 0 3 0 0 0 3 0 O 0 0 0 2
2 0 3 3 2 3 2 0 2 5 2 3 2 0 0 0 2 3 2 0 2 3 2 3 2
2 0 3 3 2 0 0 3 0 0 O 0 3 0 3 3 0 3 3 0 3 0 0 0 2
2 0 2 0 2 0 2 0 2 3 2 2 2 0 2 3 2 0 2 0 2 0 0 0 2
2 3 0 6 0 2 0 0 3 0 0 0 3 0 3 0 0 3 0 0 3 6 0 0 2
2 3 0 0 3 2 2 0 2 0 0 3 2 0 2 0 2 0 0 0 0 0 2 0 2
2 0 B 0 0 0 0 3 3 0 0 0 3 0 3 0 3 0 3 0 0 4 0 0 2
2 0 2 0 2 3 2 0 2 6 2 0 2 0 2 0 2 D 2 0 0 3 2 3 2
2 0 0 0 3 3 3 0 0 0 0 0 3 0 0 1 3 0 0 5 3 0 3 0 2
2 3 2 0 2 0 2 0 2 0 0 O 0 0 2 0 2 3 0 0 2 0 2 0 2
2 0 0 3 2 0 2 3 4 0 0 3 3 0 3 0 2 3 3 0 3 0 0 0 2
2 0 2 3 2 0 2 0 2 3 2 3 2 0 2 0 2 0 2 0 2 3 2 3 2
2 0 B 0 5 0 2 0 0 0 0 0 0 0 3 0 0 0 3 0 0 0 4 0 2
2 2 2 2 2 2 2 2 2 2 2 2 2 2 2 2 2 2 2 2 2 2 2 2 2