5 15 25
2 2 2 2 2 2 2 2 2 2 2 2 2 2 2 2 2 2 2 2 2 2 2 2 2
2 ! 0 0 2 0 3 3 2 0 0 3 3 0 0 0 0 3 0 0 0 D 0 0 2
2 0 0 0 0 0 2 0 0 0 K 2 2 K 0 0 0 2 2 2 2 2 2 0 2
2 3 0 4 3 3 3 3 0 0 0 3 3 0 0 0 0 3 3 3 3 0 2 0 2
2 0 0 0 2 D 0 2 2 2 2 2 3 2 2 2 2 2 0 D 2 0 2 0 2
2 0 2 0 2 0 D 2 3 3 3 2 5 2 3 3 3 2 D 0 2 0 2 0 2
2 0 2 0 2 6 5 3 0 3 0 2 2 2 0 3 0 3 4 3 2 3 3 3 2
2 0 2 3 7 2 2 0 0 0 0 3 3 0 0 2 0 0 2 2 0 0 0 0 2
2 0 0 0 3 0 0 0 0 N 3 0 3 0 B 2 0 0 0 0 0 N 0 0 2
2 0 2 2 2 0 0 0 0 0 0 2 2 2 0 3 0 0 0 3 3 0 2 0 2
2 N 2 3 0 3 2 2 2 0 0 3 0 0 0 0 2 2 2 0 0 2 O 0 2
2 0 2 3 0 0 0 3 0 2 2 2 2 2 2 2 0 0 0 0 2 0 0 0 2
2 0 3 3 0 O 2 2 3 0 0 0 0 2 0 0 0 0 3 2 0 M 0 3 2
2 0 0 0 0 3 3 0 0 0 2 0 0 0 0 0 0 0 0 0 0 0 3 1 2
2 2 2 2 2 2 2 2 2 2 2 2 2 2 2 2 2 2 2 2 2 2 2 2 2