6 15 25
2 2 2 2 2 2 2 2 2 2 2 2 2 2 2 2 2 2 2 2 2 2 2 2 2
2 D 0 0 0 2 0 0 0 0 7 0 ! 0 4 0 0 0 0 2 0 0 0 D 2
2 0 0 0 2 0 0 0 0 0 0 2 0 2 0 0 0 0 0 0 2 0 0 0 2
2 0 0 2 0 3 3 0 0 3 3 0 6 0 3 3 0 0 3 3 0 2 0 0 2
2 0 0 0 3 0 0 3 3 0 0 3 0 3 0 0 3 3 0 0 3 0 0 0 2
2 3 3 2 0 3 0 0 0 0 3 0 0 0 3 0 0 0 0 3 0 2 3 3 2
2 3 3 3 2 0 3 0 0 3 0 0 8 0 0 3 0 0 3 0 2 3 3 3 2
2 3 3 3 3 2 0 3 3 0 0 0 0 0 0 0 3 3 0 2 3 3 3 3 2
2 0 0 0 0 0 2 0 0 0 3 3 0 3 3 0 0 0 2 0 0 0 0 0 2
2 2 2 2 0 2 0 2 0 3 0 0 5 0 0 3 0 2 0 2 0 2 2 2 2
2 0 0 0 0 0 0 0 2 0 3 0 0 0 3 0 2 0 0 0 0 0 0 0 2
2 K 0 0 0 2 0 0 3 2 0 3 2 3 0 2 3 0 0 2 0 0 0 K 2
2 0 M 0 0 2 0 3 0 0 2 2 1 2 2 0 0 3 0 2 0 0 M 0 2
2 M 0 K 0 2 3 0 0 0 0 3 0 3 0 0 0 0 3 2 0 K 0 M 2
2 2 2 2 2 2 2 2 2 2 2 2 2 2 2 2 2 2 2 2 2 2 2 2 2